1111111111111
10000000000E1
1000000000011
1111100000001
11000C0000111
1111111111111