1111111111111
1C0000000C0E1
1C0000PC00011
1111100000001
110C0000C0011
1111111111111
