1111111111111111111111111
1000C0000C0000001000000C1
1C0000P000000000100001111
111110000111000010000NCE1
1000C00000000000000001111
10000000C0011110000C00001
1000000000000000011111001
1000000000000000000000001
1C000000C0011100CC0000001
1111000010000000000000001
100C0000100000111000000C1
1000000010000000000001111
1C000000100000CC000000001
1111111111111111111111111