1111111111111
10000000000E1
100000P000011
1111100000001
1100000C00111
1111111111111
