1111111111111
1C00C0000C0E1
1C1000PC00011
1111100000001
110C0000C0011
1111111111111